%%%%%%%%%%%%%%%%%%%%%%%%%%%%%%%%%%%%%%%%%%%%
%     .   ..    ..        ..    ..   .     %
% % % %%%%%%%%%%%%%% %% %%%%%%%%%%%%%% % % %
% % % .  .  .  .  .  %%  .  .  .  .  . % % %
%1%.% %%%%%%%%%%%%%% %% %%%%%%%%%%%%%% %.%2%
%%%%% .  .  .  .  .      .  .  .  .  . %%%%%
%o . 5%%%%..%%%%..%%%%%%%%..%%%%..%%%%6   o%
%%%%% .  .  .  .  .      .  .  .  .  . %%%%%
%3%.% %%%%%%%%%%%%%% %% %%%%%%%%%%%%%% %.%4%
% % % .  .  .  .  .  %%  .  .  .  .  . % % %
% % % %%%%%%%%%%%%%% %% %%%%%%%%%%%%%% % % %
%     .   ..    ..        ..    ..   .     %
%%%%%%%%%%%%%%%%%%%%%%%%%%%%%%%%%%%%%%%%%%%%