%%%%%%%%%%%%%%%%%%%%%%%%%%%%%%%%%%%%%%%%
%   %   %. %.%.%       %     %.%.%   %4%
% % % % %%       %%  %   %%%   %.% % %2%
% % % % %. % %%%    %%%% .%..% % % % %6%
% % % % %% % ..% %   %   %%%%% % % % % %
% % % %    %%%%% %%%   %%%.% o % % % % %
% % % %% % ....  %.%%%       %   % % % %
% % % %. %%.%%%%        %.%%%%  %% % % %
% % % %%  %%%%.%        %%%%.%% .% % % %
% % % %   %       %%%.%  .... % %% % % %
% % % % % o %.%%%   %%% %%%%%    % % % %
% % % % % %%%%%   %   % %.. % %% % % % %
%5% % % % %..%. %%%%    %%% % .% % % % %
%1% % %.%   %%%   %  %%       %% % % % %
%3%   %.%.%     %       %.%.% .%   %   %
%%%%%%%%%%%%%%%%%%%%%%%%%%%%%%%%%%%%%%%%
