%%%%%%%%%%%%%%%%%%%%%%%%%%%%%%%%
%   %.%%.%   %           %.%.%4%
% % %      %    %%%% %%%   %.%2%
% % % %  %%% %       .%..%   %6%
% % % %  ..% %.%%%% %%%%%% % % %
% % % %%%%%% %%%%.% %..  % % % %
%5%   %..%.       % %%%  % % % %
%1%.%   %%% %%%%    %      % % %
%3%.%.%           %   %.%%.%   %
%%%%%%%%%%%%%%%%%%%%%%%%%%%%%%%%
