%%%%%%%%%%%%%%%%%%%%%%%%%%%%%%%%%%%%%%
%1%  .%.%.%   %.%      %.%%%     %   %
%3% %.% %          %%% %     % % % % %
%5% % %   %%% %%% %%     %%%%% %.% % %
% % % % % %.%  .%.%  %%% %     %.% % %
% % % % % % % %%%%%  %.%   %%% %%% % %
% % %   %.% % %        % % %.%   % % %
% % %%% %%%   %.%  %%%%% % % % % % % %
% % %.%     % %%%  %.%.  %.% % % % % %
% % %.% %%%%%     %% %%% %%%   % % %6%
% % % % %     % %%%          % %.% %4%
%   %     %%%.%      %.%   %.%.%.  %2%
%%%%%%%%%%%%%%%%%%%%%%%%%%%%%%%%%%%%%%