%%%%%%%%%%%%%%%%%%%%%%%%%%%%%%%%%%%%%%%%%%%%%%
%1%o                %%%%%%                o%2%
% % %%%%%%%%%%%%%%% %%%%%% %%%%%%%%%%%%%%% % %
% % %.................%%.................% % %
% % %.%%%%%%%%%%%%% %%%%%% %%%%%%%%%%%%%.% % %
% % %.%...........%        %...........%.% % %
% % %.%%.%..%..% %% %%%%%% %% %..%..%.%%.% % %
% % %....%%.%%.%              %.%%.%%....% % %
% % %%%%%%..%..%%%% %%%%%% %%%%..%..%%%%%% % %
% % %    %.%%.%%.....    .....%%.%%.%    % % %
% % % %% %..%..%.%%%.%%%%.%%%.%..%..% %% % % %
%     %% %%.%%.%.%%%.%%%%.%%%.%.%%.%% %%     %
%%%%%%%%  ..%..%.....    .....%..%..  %%%%%%%%
%     %%%%.%%.%%%%% %%%%%% %%%%%.%%.%%%%     %
% %.%        5                  6        %.% %
% %.%%%%%%%%% %%%%% %%%%%% %%%%% %%%%%%%%%.% %
% %.%...%  ...%...% %    % %...%...  %...%.% %
% %...%.. %.%.%.%.%...%%...%.%.%.%.% ..%...% %
% %.%...% %.%.%...%.%.%%.%.%...%.%.% %...%.% %
%3%...%.% %.%.% % %...%%...% % %.%.% %.%...%4%
% %.%...% %...    %.%.%%.%.%    ...% %...%.% %
% %...%.. %%%%% % %...%%...% % %%%%% ..%...% %
% %.....%    %....%.%.%%.%.%....%    %.....% %
% %%%%%%%%%% %..%.%...%%...%.%..% %%%%%%%%%% %
%           o%......%    %......%o           %
%%%%%%%%%%%%%%%%%%%%%%%%%%%%%%%%%%%%%%%%%%%%%%